@########@#######
>               #
####@###@       #
        #       #
        # !   ! #
        #########